5 5 15
12
0 0 -5 0
1 0 -5 0
2 0 -5 0
3 0 -5 0
4 0 -5 0
0 1 -5 0
1 1 -5 0
2 1 -5 0
3 1 -5 0
4 1 -5 0
0 2 -5 0
1 2 -5 0
2 2 -5 1
3 2 -5 0
4 2 -5 0
0 3 -5 0
1 3 -5 0
2 3 -5 0
3 3 -5 0
4 3 -5 0
0 4 -5 0
1 4 -5 0
2 4 -5 0
3 4 -5 0
4 4 -5 0
